1111111111111111111111111111111111111111
1XXXXXXXXXXXXXXXXXXXXXXXXXXXXXXXXXXXXXX1
1X00000X000X0000000H00000000X000X00000X1
1X01111X011X0111111111111110X110X11110X1
1X01111X011XXXXXXX0110XXXXXXX110X11110X1
1X011XXX011000000X0110X000000110XXX110X1
1X011X00011111111X0110X11111111000X110X1
1X011X01111111111X0110X11111111110X110X1
1X011X01111XXXXXXXXXXXXXXXXXX11110X110X1
1X011XXX011X0000000000000000X110XXX110X1
1X01100X011X0111111P01111110X110X00110X1
1X01111X011X01XXXXXXXXXXXX10X110X11110X1
1X01111X011X0100000000000010X110X11110X1
1XXXXXXX011X0111111111111110X110XXXXXXX1
1X00000X011XXXXXXX0110XXXXXXX110X00000X1
1XV1111XXXXX00000X0110X00000XXXXX1111VX1
1X01111X000X01111X0110X11110X000X11110X1
1X00000X011X01111X0110X11110X110X00000X1
1XXXXXXX011X01100X0000X00110X110XXXXXXX1
1X01111X011X011XXXXXXXXXX110X110X11110X1
1X01111X011X011X01111110X110X110X11110X1
1X01100X011X011X01111110X110X110X00110X1
1X011XXX011X000X00000000X000X110XXX110X1
1X011X01111XXXXXXXXXXXXXXXXXX11110X110X1
1X011X01111111111X0110X11111111110X110X1
1X011X00011111111X0110X11111111000X110X1
1X011XXX011000000X0110X000000110XXX110X1
1X01111X011XXXXXXX0110XXXXXXX110X11110X1
1X01111X011X0111111111111110X110X11110X1
1X00000X000X0000000H00000000X000X00000X1
1XXXXXXXXXXXXXXXXXXXXXXXXXXXXXXXXXXXXXX1
1111111111111111111111111111111111111111