1111111111111111111111111111111111111111
1XX0000000000000000000000000000000000001
1000000000000000000H00000000000000000001
1001111001100111111111111110011001111001
1001111001100000000110000000011001111001
1001100001100000000110000000011000011001
1001100001111111100110011111111000011001
1001100111111111100110011111111110011001
1001100111100000000000000000011110011001
1001100001100000000000000000011000011001
1001100001100111111P01111110011000011001
1001111001100100000000000010011001111001
1001111001100100000000000010011001111001
1000000001100111111111111110011000000001
1000000001100000000110000000011000000001
10V1111000000000000110000000000001111V01
1001111000000111100110011110000001111001
1000000001100111100110011110011000000001
1000000001100110000000000110011000000001
1001111001100110000000000110011001111001
1001111001100110011111100110011001111001
1001100001100110011111100110011000011001
1001100001100000000000000000011000011001
1001100111100000000000000000011110011001
1001100111111111100110011111111110011001
1001100001111111100110011111111000011001
1001100001100000000110000000011000011001
1001111001100000000110000000011001111001
1001111001100111111111111110011001111001
1000000000000000000H00000000000000000001
1000000000000000000000000000000000000001
1111111111111111111111111111111111111111