11111111111111111111111111111111111111
1XXXXXXXXXXXXXXXXXXXXXXXXXXXXXXXXXXXX1
1X0000000000000000H00000000000000000X1
1X0110000000000000000000000000000110X1
1X0110000000000000000000000000000110X1
1X0000000000000000000000000000000000X1
1X0000000000000000000000000000000000X1
1X0110000000000000000000000000000110X1
1X0110000000000000000000000000000110X1
1X0110000000000000000000000000000110X1
1X0110000000000000000000000000000110X1
1X0110000000000000000000000000000110X1
1X0000011110011111P01111100111100000X1
1X0000011110011111001111100111100000X1
1XV11001100001100000000110000110011VX1
1X0110011000011000000001100001100110X1
1X0000011110011111111111100111100000X1
1X0000011110011111111111100111100000X1
1X0110000000000000000000000000000110X1
1X0110000000000000000000000000000110X1
1X0110000000000000000000000000000110X1
1X0110000000000000000000000000000110X1
1X0110000000000000000000000000000110X1
1X0000000000000000000000000000000000X1
1X0000000000000000000000000000000000X1
1X0110000000000000000000000000000110X1
1X0110000000000000000000000000000110X1
1X0000000000000000H00000000000000000X1
1XXXXXXXXXXXXXXXXXXXXXXXXXXXXXXXXXXXX1
11111111111111111111111111111111111111
